NO xpm/north.xpm
SO xpm/south.xpm
WE xpm/west.xpm
EA xpm/east.xpm
				
F	220,100,0
C	225,30,0


	    1111111111111111111111111 1
	    1000000000110000000000001 1
	    1011000001110000000000001 1
	    1001000000000000000000001 1
111111111011000001110000111110001 1
10000000001100000111011111111111111
11110111111111011100000010001
11110111111111011101010010001
110000001101010111000000100011  1111111111
100000000000000011000000100011  1111111111
100000000000000011010100100011  1111111111
11000001110101011111011110N01     1111111
11110111 1110101 101111010001	11111111111
11111111 1111111 111111111111	11111111111
								11111111111	
								11111111111	
								11111111111	
								11111111111	
								11111111111	
								11111111111	
								11111111111	
								11111111111	
								11111111111	
								11111111111	
								11111111111	
								11111111111	
								11111111111	
								11111111111	
								11111111111	
								11111111111	
								11111111111	
								11111111111	
								11111111111	
								11111111111	
								11111111111	
								11111111111	
								11111111111
								11111111111
								11111111111
								11111111111
								11111111111
								11111111111
								11111111111
								11111111111
								11111111111