NO xpm/south.xpm
SO xpm/south.xpm
WE xpm/west.xpm					
EA xpm/east.xpm
											
F	220,100,0
C	225,30,0


         11111111111111
      111111111101100011
      100000000011000001111
    111101111111110111000011
  1111111111111000000000000111
111101111111110100010000000001
110000001101010110001000000001
1011111111111100E0000000000111
11111        11100000000000011
 11111111111111000000000000111
  111111110101101111010001111
    11111111111111111111111















