NO 															xpm/south.xpm
SO 														xpm/south.xpm
WE 															xpm/west.xpm					
EA 															xpm/east.xpm
											
F 									220,100,0
C 225,30,0


         1111111111111
       11111111101100011
      10000000001100000111
    111101111111110111000011
  111111111111100000000000011
111101111111110100010000000001
110000001101010110001000000001
1011111111111110E000000000011
 111         110000000000001
   111111111111000000000000111
       11101011011110100011
         1111111111111111















