NO xpm/north.xpm
SO xpm/south.xpm
WE xpm/west.xpm
EA xpm/east.xpm

F	255,255,255
C	225,30,123



	    1111111111111111111111111
	    1000000000110000000000001
	    1011000001110000000000001
	    1001000000000000000000001
111111111011000001110000111110001
100000000011000001110101111111111
11110111111111011100000010001
11110111111111011101010010001
10000000110101011100000010001
10000000000000001100000010001
1000c00c00W000011010100100011
11000001110101011111011110001
11110111 1110101 101111010001
11111111 1111111 111111111111
