NO ../xpm/north.xpm
SO ../xpm/south.xpm
WE ../xpm/west.xpm
EA ../xpm/east.xpm

F 220,100,0
C 225,30,0

        1111111111  1111111111111
        1000000000110000000000001
        1011000001110000000000001
        1001000000000000000000001
111111111011000001110000000000001
100000000011000001110111111111111
111101111111110111000000100011111
11111111111111111111111 11111111111111111
11110111111111011111111111111101010010001
11000000110101011111111111111100000010001
10000000000000011011111111111111111111111
10000000000000001111111111111101010010001
11000001110101011111111111111111011110N0111
11110111 1110101 10111101000111111111111
11111111 1111111 111111111111