NO xpm/south.xpm
SO xpm/south.xpm
WE xpm/west.xpm
EA xpm/east.xpm

F	255,255,255
C	225,30,123



        1111111111111111111111111111
        1111000000000110000000000001
        1111011000001110000000000001
        1111001000000000000000000001
111111111110110000011100001111100011
100000000011000001110111111111111111
111101111111110111000000101111111111
111101111111110111010100101111111111
110000001101010111000000100011111111
100000000000000011000000000011111111 
100000000000000011010100100011111111 
11000001110101011111011110N011111111
11110111 1110101 1011110100011111111
11111111 1111111 1111111111111111111
