NO ../xpm/north.xpm
SO ../xpm/south.xpm
WE ../xpm/west.xpm
EA ../xpm/west.xpm

F     220,100,0
C     192,819,287

1111









111111111
sdasdasdasd
asd
asdda
sdasdasdasdasd
asddaasd
asddaasdasd
